border_size=1
usage=map

Gg^Gvs      , Gg^Gvs      , Gg^Gvs      , Gg^Gvs      , Gg^Gvs      , Gg^Gvs      , Gg^Eff      , Gg^Gvs      , Gg          , Gg          , Gg^Es       , Gd          , Re          , Re          , Re          , Rd          , Rb          , Rb          , Rd          , Dd          , Ds          , Ds          , Ww          , Ds          , Ds          , Ds          , Ds          , Ds          , Ww          , Ds          , Ds          , Dd          , Rd          , Rb          , Rb          , Rd          , Re          , Re          , Re          , Gd          , Gg^Es       , Gg          , Gg          , Gg^Gvs      , Gg^Eff      , Gg^Gvs      , Gg^Gvs      , Gg^Gvs      , Gg^Gvs      , Gg^Gvs      , Gg^Gvs      
Gg^Gvs      , Gg^Gvs      , Gg^Gvs      , Gg^Gvs      , Gg^Eff      , Gg^Eff      , Rp^Eff      , Rp^Eff      , Rp^Eff      , Gg          , Gg          , Gd          , Gd          , Re          , Re          , Rd          , Rd          , Rb          , Rd          , Hd          , Dd          , Ds          , Ds          , Ww          , Wwf         , Ds          , Wwf         , Ww          , Ds          , Ds          , Dd          , Hd          , Rd          , Rb          , Rd          , Rd          , Re          , Re          , Gd          , Gd          , Gg          , Gg          , Rp^Eff      , Rp^Eff      , Rp^Eff      , Gg^Eff      , Gg^Eff      , Gg^Gvs      , Gg^Gvs      , Gg^Gvs      , Gg^Gvs      
Rrc         , Rrc         , Rrc         , Gg^Gvs      , Gg^Eff      , Rp^Eff      , Rr^Vhc      , Rrc         , Rr^Vhc      , Rp^Eff      , Gg          , Gg          , Gg          , Gd          , Gd          , Re          , Rd          , Rd^Esd      , Rd^Esd      , Dd          , Rd          , Re          , Re          , Re          , Rb          , Wwf         , Rb          , Re          , Re          , Re          , Rd          , Dd          , Rd^Esd      , Rd^Esd      , Rd          , Re          , Gd          , Gd          , Gg          , Gg          , Gg^Eff      , Rp^Eff      , Rr^Vhc      , Rrc         , Rr^Vhc      , Rp^Eff      , Gg^Eff      , Gg^Gvs      , Rrc         , Rrc         , Rrc         
Rrc         , Cud         , Rrc         , Rrc         , Rrc         , Gg^Eff      , Gg^Eff      , Rrc         , Gg^Eff      , Gg^Eff      , Rrc         , Rrc         , Rrc         , Gg          , Gg          , Gd          , Gd          , Rd          , Rd          , Rd          , Gd          , Rd          , Rr          , Rr          , Rp          , Wwf         , Rp          , Rr          , Rr          , Rd          , Gd          , Rd          , Rd          , Rd          , Gd          , Gd          , Gg          , Gg          , Rrc         , Rrc         , Rrc         , Gg^Eff      , Gg          , Rrc         , Gg^Eff      , Gg^Eff      , Rrc         , Rrc         , Rrc         , Cud         , Rrc         
Rrc         , Rrc^Bsb|    , Rrc         , Gg^Es       , Gg^Es       , Rrc         , Rrc         , Rrc         , Rrc         , Rrc         , Gg^Es       , Gg^Es       , Gg^Es       , Rrc         , Rrc         , Gg          , Gg          , Gd          , Rr          , Gd          , Rr          , Rr          , Rp          , Rp          , Ww^Bw\      , Ww          , Ww^Bw/      , Rp          , Rp          , Rr          , Rr          , Gd          , Rr          , Gd          , Gg          , Gg          , Rrc         , Rrc         , Gg^Es       , Gg^Es       , Gg^Es       , Rrc         , Rrc         , Rrc         , Rrc         , Rrc         , Gg^Es       , Gg^Es       , Rrc         , Rrc^Bsb|    , Rrc         
Rrc         , Rrc^Bsb|    , Rrc         , Gg^Es       , Hh^Fms      , Gg^Es       , Gg^Es       , Gg          , Gg^Em       , Gg^Es       , Hh^Fms      , Hh          , Hh^Fms      , Gg^Es       , Gg          , Rrc         , Rrc         , Rr          , Cud         , Rr          , Rp          , Rp          , Ww          , Ww          , Rp          , Rp          , Rp          , Ww          , Ww          , Rp          , Rp          , Rr          , Cud         , Rr          , Rrc         , Rrc         , Gg          , Gg^Es       , Hh^Fms      , Hh          , Hh^Fms      , Gg^Es       , Gg          , Gg          , Gg^Es       , Gg^Es       , Hh^Fms      , Gg^Es       , Rrc         , Rrc^Bsb|    , Rrc         
Rrc         , Cud         , Rrc         , Gg^Es       , Gs^Fms      , Hh^Fms      , Gg^Em       , Gg^Em       , Gg^Em       , Gg^Em       , Gs^Fms      , Gs^Fds      , Gs^Fms      , Gg^Em       , Gg^Em       , Gg          , Gs          , Rp          , Rr          , Rr          , Rp          , Ww          , Rp          , Rp          , Iwr         , Ket         , Iwr         , Rp          , Rp          , Ww          , Rp          , Rr          , Rr          , Rp          , Gs          , Gg          , Gg^Em       , Gg^Em       , Gs^Fms      , Gs^Fds      , Gs^Fms      , Gg^Em       , Gg^Em       , Gg^Em       , Gg^Em       , Hh^Fms      , Gs^Fms      , Gg^Es       , Rrc         , Cud         , Rrc         
Rrc         , Cud         , Rrc         , Gg^Es       , Gg^Em       , Gs^Fms      , Gs^Fms      , Gs^Fms      , Gs^Fms      , Gs^Fms      , Gg^Efm      , Gg^Efm      , Gg^Efm      , Gs^Fms      , Ke          , Gs^Fms      , Gs^Fms      , Gs          , Rr          , Rp          , Ww^Bw\      , Ww          , Rp          , Iwr         , Iwr         , Iwr         , Iwr         , Iwr         , Rp          , Ww          , Ww^Bw/      , Rp          , Rr          , Gs          , Gs^Fms      , Gs^Fms      , Ke          , Gs^Fms      , Gg^Efm      , Gg^Efm      , Gg^Efm      , Gs^Fms      , Gs^Fms      , Gs^Fms      , Gs^Fms      , Gs^Fms      , Gg^Em       , Gg          , Rrc         , Cud         , Rrc         
Rrc         , 1 Kud       , Rrc         , Gg          , Gg^Em       , Gs^Fds      , Gs^Fms      , Hh^Fds      , Gs^Fms      , Gs^Fds      , Gg^Efm      , Gg^Fet      , Gg^Efm      , Gs^Fds      , Ke          , Ke          , Gs^Fms      , Gs^Vl       , Rr          , Rp          , Ww^Bw/r     , Rp          , Rp          , Iwr         , Iwr         , Rr          , Iwr         , Iwr         , Rp          , Rp          , Ww^Bw\      , Rp          , Rr          , Gs^Vl       , Gs^Fms      , Ke          , Ke          , Gs^Fds      , Gg^Efm      , Gg^Fet      , Gg^Efm      , Gs^Fds      , Gs^Fms      , Hh^Fds      , Gs^Fms      , Gs^Fds      , Gg^Em       , Gg          , Rrc         , 2 Kud       , Rrc         
Rrc         , Cud         , Rrc         , Gg          , Gs^Fms      , Gs^Fms      , Gg^Em       , Gs^Fms      , Gg^Em       , Gs^Fms      , Gs^Fms      , Gg^Efm      , Gs^Fms      , Gs^Fms      , Gg^Em       , Gs^Fms      , Gs          , Gs          , Rr          , Rp          , Rp          , Ww          , Rp          , Iwr         , Iwr         , Iwr         , Iwr         , Iwr         , Rp          , Ww          , Rp          , Rp          , Rr          , Gs          , Gs          , Gs^Fms      , Gg^Em       , Gs^Fms      , Gs^Fms      , Gg^Efm      , Gs^Fms      , Gs^Fms      , Gg^Em       , Gs^Fms      , Gg^Em       , Gs^Fms      , Gs^Fms      , Gg^Es       , Rrc         , Cud         , Rrc         
Rrc         , Cud         , Rrc         , Gg^Es       , Hh^Fms      , Hh^Fms      , Gg^Es       , Gg^Em       , Gg^Es       , Gg^Em       , Hh^Fms      , Gs^Fds      , Hh^Fms      , Gg^Em       , Gg          , Gg          , Rrc         , Rp          , Cud         , Rr          , Rp          , Ww          , Ww          , Rp          , Rp          , Ket         , Rp          , Rp          , Ww          , Ww          , Rp          , Rr          , Cud         , Rp          , Rrc         , Gg          , Gg          , Gg^Em       , Hh^Fms      , Gs^Fds      , Hh^Fms      , Gg^Em       , Gg          , Gg^Em       , Gg^Es       , Hh^Fms      , Hh^Fms      , Gg^Es       , Rrc         , Cud         , Rrc         
Rrc         , Rrc^Bsb|    , Rrc         , Gg^Es       , Gg^Es       , Gg^Es       , Rrc         , Gg^Es       , Rrc         , Gg^Es       , Gg^Es       , Hh          , Gg^Es       , Gg^Es       , Rrc         , Rrc         , Gg          , Rr          , Rr          , Rr          , Rr          , Rp          , Rp          , Ww          , Ww^Bw/      , Rp          , Ww^Bw\      , Ww          , Rp          , Rp          , Rr          , Rr          , Rr          , Rp          , Gg          , Rrc         , Rrc         , Gg^Es       , Gg^Es       , Hh          , Gg^Es       , Gg^Es       , Rrc         , Gg^Es       , Rrc         , Gg^Es       , Gg^Es       , Gg^Es       , Rrc         , Rrc^Bsb|    , Rrc         
Rrc         , Rrc^Bsb|    , Rrc         , Gg^Es       , Rrc         , Rrc         , Gg^Es       , Rrc         , Gg^Es       , Rrc         , Rrc         , Gg          , Rrc         , Rrc         , Gg          , Gg          , Gg^Es       , Gg          , Gs          , Gs          , Gs          , Rr          , Rr          , Rp          , Rp          , Ww          , Rp          , Rp          , Rr          , Rr          , Gs          , Gs          , Gs          , Gg          , Gg^Es       , Gg          , Gg          , Rrc         , Rrc         , Gg^Es       , Rrc         , Rrc         , Gg^Es       , Rrc         , Gg^Es       , Rrc         , Rrc         , Gg          , Rrc         , Rrc^Bsb|    , Rrc         
Rrc         , Cud         , Rrc         , Rrc         , Gg^Es       , Gg^Es       , Gs^Es       , Gg^Es       , Gs^Es       , Gg^Es       , Gg^Es       , Rrc         , Gg          , Gg          , Gg          , Gg^Es       , Gg          , Gg^Es       , Gg          , Gg^Es       , Gg          , Gs          , Gs          , Rr          , Gs          , Ww          , Gs          , Rr          , Gs          , Gs          , Gg          , Gg^Es       , Gg          , Gg^Es       , Gg          , Gg^Es       , Gg          , Gg          , Gg          , Rrc         , Gg^Es       , Gg          , Gg^Es       , Gg^Es       , Gg^Es       , Gg          , Gg^Es       , Rrc         , Rrc         , Cud         , Rrc         
Gg          , Rrc         , Gg^Es       , Gg^Es       , Hh          , Gs^Es       , Hh          , Hh^Vhh      , Hh          , Gs^Es       , Hh          , Gg^Es       , Gg^Es       , Gg          , Re          , Re          , Re          , Re          , Re          , Re          , Ss          , Gg          , Ss^Vhs      , Gs          , Ww          , Ww          , Ww          , Gs          , Ss^Vhs      , Gg          , Ss          , Re          , Re          , Re          , Re          , Re          , Re          , Gg          , Gg^Es       , Gg^Es       , Hh          , Gg^Es       , Hh          , Hh^Vhh      , Hh          , Gg^Es       , Hh          , Gg^Es       , Gg^Es       , Rrc         , Gg          
Gg^Es       , Gg^Es       , Hh          , Hh          , Mm          , Hh          , Mm          , Mm          , Mm          , Hh          , Md          , Hh          , Hh          , Gg^Es       , Re          , Sm          , Sm          , Sm          , Sm          , Ss          , Ww          , Ss          , Ww          , Ss          , Sm          , Ss          , Sm          , Ss          , Ww          , Ss          , Ww          , Ss          , Sm          , Sm          , Sm          , Sm          , Re          , Gg^Es       , Hh          , Hh          , Md          , Hh          , Mm          , Mm          , Mm          , Hh          , Mm          , Hh          , Hh          , Gg^Es       , Gg^Es       
Gg          , Hh          , Hh          , Mm          , Mm          , Mm          , Mm          , Wo          , Mm          , Mm          , Md          , Md          , Hh          , Hhd         , Re          , Re          , Sm          , Ss          , Sm          , Ww          , Ss          , Ss          , Sm          , Ss          , Ss          , Ss          , Ss          , Ss          , Sm          , Ss          , Ss          , Ww          , Sm          , Ss          , Sm          , Re          , Re          , Hhd         , Hh          , Md          , Md          , Mm          , Mm          , Wo          , Mm          , Mm          , Mm          , Mm          , Hh          , Hh          , Gs^Es       
