border_size=1
usage=map

Gll         , Gll         , Re          , Gll         , Re          , Rd          , Hhd^Fdw     , Hhd^Fmw     , Hhd^Fmf     , Gd^Fdf      , Rp          , Gd^Fdf      , Gll         , Gll         , Gll^Fmf     , Gll         , Gll^Fmf     , Gd^Fdf      , Gd^Fdf      , Gd^Fdf      , Gll         , Gll         , Re          , Gll         , Hhd^Fdw     , Gd^Fdf      , Gll^Fmf     
Gd          , Re^Vct      , Ce          , Ce          , Ce          , Rd          , Hhd^Fdw     , Hhd^Fmw     , Hhd^Fdf     , Gd^Fdf      , Rp          , Gd^Fdf      , Gll         , Gd^Fdf      , Gll^Fmf     , Gll^Fmf     , Hhd^Fdf     , Hhd^Fdf     , Rd          , Gll         , Ce          , Ce          , Ce          , Re^Vct      , Rb          , Gd^Fmw      , Gll^Fmf     
Re          , Uue^Ii      , Ce          , 4 Ke        , Ce          , Uue^Ii      , Rd          , Rd          , Gd^Fdf      , Rd          , Rd          , Rp          , Rp          , Gd          , Rd          , Gd^Fdf      , Hhd^Fdf     , Gd^Fdf      , Ds          , Uue^Ii      , Ce          , 1 Ke        , Ce          , Uu^Ii       , Hhd^Fdw     , Gd^Fmw      , Gll^Fmf     
Gd          , Re          , Rd          , Ce          , Re          , Rd          , Ww          , Rd          , Ds          , Ds          , Rd          , Gd          , Rp          , Gd          , Re          , Rd          , Ds          , Ds          , Ww          , Rd          , Re          , Ce          , Rb          , Rb          , Re          , Hhd^Fdw     , Gll^Fmf     
Gs          , Rb          , Re          , Rd          , Ww          , Ww          , Ch          , Ww          , Ww          , Ww          , Ww^Bw|      , Ww          , Ww^Bw|      , Ww          , Ww^Bw|r     , Ww          , Ww          , Ww          , Ch          , Ww          , Ww          , Gd          , Gll         , Re          , Hhd^Fdw     , Hhd^Fdw     , Hhd^Fmf     
Rb          , Rb          , Ww          , Ww          , Ch          , Ch          , Rrc         , Ch          , Ch          , Re          , Re^Bw|      , Gd          , Ch          , Gll         , Re^Bw|      , Rb          , Ch          , Ch          , Rrc         , Ch          , Ch          , Ww          , Ww          , Rd          , Gll         , Hhd         , Gd^Fdf      
Gs          , Gs          , Ww          , Ch          , Rrc         , Rrc         , Rrc         , Rrc         , Rrc         , Ch          , Ch          , Ch          , Rrc         , Ch          , Ch          , Ch          , Rrc         , Rrc         , Rrc         , Rrc         , Rrc         , Ch          , Ww          , Ds          , Gd          , Gd^Fdf      , Gd^Fdf      
Gg          , Sm          , Ww^Ewl      , Ch          , Rrc         , Rrc         , Rr^Vhc      , Rrc         , Rrc         , Rrc         , Rrc         , Rrc         , Rrc         , Rrc         , Rrc         , Rrc         , Rrc         , Rrc         , Rr^Vhc      , Rrc         , Rrc         , Ch          , Ww          , Ds          , Gd^Fdf      , Hhd^Fdf     , Hhd^Fmf     
Gg          , Ss          , Ww^Ewl      , Ch          , Rrc         , Rrc         , Rrc         , Rrc         , Rrc         , Rrc         , Rrc         , Rrc         , Rrc         , Rrc         , Rrc         , Rrc         , Rrc         , Rrc         , Rrc         , Rrc         , Rrc         , Ch          , Ww          , Ds          , Gd^Fdf      , Gll^Fmf     , Hhd^Fmf     
Ss          , Gg          , Wwg         , Ch          , Ch          , Rrc         , Rrc         , Rrc         , Rrc         , Rrc         , Rrc         , 5 Kh        , Kh          , 8 Kh        , Rrc         , Rrc         , Rrc         , Rrc         , Rrc         , Rrc         , Ch          , Ch          , Ww          , Rd          , Re          , Gd^Fdf      , Gd^Fdf      
Ss          , Sm          , Ss          , Wwg         , Gs          , Ch          , Ch          , Chr         , Ch          , Rrc         , Rrc         , Kh          , Kh          , Kh          , Rrc         , Rrc         , Ch          , Ch          , Ch          , Ch          , Gll         , Ww          , Re          , Re          , Gd^Fdf      , Hhd^Fdf     , Hhd         
Ss          , Sm          , Sm          , Ww^Ewl      , Ww^Ewl      , Gg          , Ss          , Gg          , Ch          , Rrc         , Rrc         , Kh          , Kh          , Kh          , Rrc         , Rrc         , Ch          , Rb          , Rb          , Gll         , Gd          , Ww          , Rb          , Re          , Re          , Hhd         , Hhd^Fdf     
Ss          , Ss          , Ss          , Wwf         , Ss          , Ss          , Sm          , Gg          , Ch          , Rrc         , Rrc         , Kh          , Kh          , Kh          , Rrc         , Rrc         , Ch          , Re          , Qxu         , Uh^Dr       , Gd^Dr       , Wwf         , Gd          , Gs          , Hhd^Fdf     , Hhd^Fdf     , Hhd^Fmf     
Ss          , Gs          , Ss          , Ww^Ewl      , Gs          , 9 Ss^Vhs    , Sm          , Sm          , Ch          , Rrc         , Rrc         , Kh          , Kh          , Kh          , Rrc         , Rrc         , Ch          , Re          , Uh^Dr       , Gd^Vhr      , Re          , Ww          , Re          , Gd^Fdf      , Gd^Fdf      , Hhd^Fmf     , Hhd^Fmf     
Ss          , Sm          , Wwf         , Ww^Ewl      , Ww^Ewl      , Wwf         , Sm          , Sm          , Ch          , Rrc         , Rrc         , Kh          , Kh          , Kh          , Rrc         , Rrc         , Ch          , Gll         , Rd          , Rd          , Re          , Wwf         , Re          , Re          , Gd^Fdf      , Gll^Fmf     , Gd^Fdf      
Ss          , Ss          , Gg          , Wwf         , Sm          , Gs          , Ch          , Gg          , Ch          , Rrc         , Rrc         , Kh          , Kh          , Kh          , Rrc         , Rrc         , Ch          , Rd          , Ch          , Gd          , Gll         , Ww          , Rd          , Gd^Fdf      , Gd          , Hhd         , Hhd^Fmf     
Sm          , Sm          , Ww^Ewl      , Ww^Ewl      , Ch          , Ch          , Rrc         , Ch          , Rrc         , Rrc         , Rrc         , Kh          , Kh          , Kh          , Rrc         , Rrc         , Rrc         , Ch          , Rrc         , Ch          , Ch          , Ww          , Ww          , Ds          , Gd^Fdf      , Gll^Fmf     , Gll^Fmf     
Sm          , Ss          , Ww          , Ch          , Rrc         , Rrc         , Rrc         , Rrc         , Rrc         , Rrc         , Rrc         , 6 Kh        , Rrc         , 7 Kh        , Rrc         , Rrc         , Rrc         , Rrc         , Rrc         , Rrc         , Rrc         , Ch          , Ww          , Ds          , Gd          , Gd^Fdf      , Hhd^Fmf     
Ss          , Sm          , Ww^Ewl      , Ch          , Rrc         , Rrc         , Rr^Vhc      , Rrc         , Rrc         , Rrc         , Rrc         , Rrc         , Rrc         , Rrc         , Rrc         , Rrc         , Rrc         , Rrc         , Rr^Vhc      , Rrc         , Rrc         , Ch          , Ww          , Ds          , Gd^Fdf      , Gs          , Gd^Fdf      
Gg          , Gg          , Ww          , Ch          , Rrc         , Rrc         , Rrc         , Rrc         , Rrc         , Rrc         , Ch          , Rrc         , Rrc         , Rrc         , Ch          , Rrc         , Rrc         , Rrc         , Rrc         , Rrc         , Rrc         , Ch          , Ww          , Ds          , Gll         , Gll^Fmf     , Hhd^Fmf     
Gg          , Sm          , Ww          , Ch          , Ch          , Rrc         , Rrc         , Rrc         , Ch          , Ch          , Re^Bw|      , Ch          , Ch          , Ch          , Re^Bw|      , Ch          , Ch          , Rrc         , Rrc         , Rrc         , Ch          , Ch          , Ww          , Rd          , Gd^Fdf      , Hhd^Fmf     , Hhd^Fmf     
Gs          , Gs          , Gs          , Ww          , Ww          , Ch          , Ch          , Ch          , Ww          , Rb          , Ww^Bw|r     , Gll         , Ww^Bw|      , Gll         , Ww^Bw|      , Gd          , Ww          , Ch          , Ch          , Ch          , Ww          , Ww          , Re          , Gd          , Hhd^Fmw     , Hhd^Fdf     , Gll^Fmf     
Gs          , Gd          , Gd          , Re          , Rd          , Ww          , Ww          , Ww          , Rd          , Ww          , Gd          , Ww          , Rp          , Ww          , Gd          , Ww          , Ds          , Ww          , Ww          , Ww          , Rb          , Re          , Re          , Gs^Fdw      , Gd^Fmw      , Hhd^Fdf     , Gll^Fmf     
Rb          , Gd          , Ce          , Ce          , Ce          , Dd          , Dd          , Ds          , Gd^Fdf      , Gd          , Gd^Fdf      , Gll         , Rp          , Gll         , Gd          , Rd          , Uue         , Ds          , Rb          , Rb          , Ce          , Ce          , Ce          , Re          , Hhd^Fdw     , Hhd^Fmw     , Gd^Fmw      
Rb          , Uue^Ii      , Ce          , 3 Ke        , Ce          , Uue^Ii      , Gs^Fdw      , Gs^Fdw      , Hhd         , Hhd         , Hhd         , Gd^Fdf      , Gd^Fdf      , Rp          , Rp          , Hhd^Fdw     , Uu          , Uu          , Gd^Fmw      , Uue^Ii      , Ce          , 2 Ke        , Ce          , Uu^Ii       , Ur          , Hhd^Fdw     , Gs^Dr       
Re          , Re^Vct      , Rb          , Ce          , Re          , Rd          , Hhd^Fdw     , Hhd^Fmw     , Mm          , Mm          , Mm          , Hhd^Fdf     , Hhd^Fdf     , Hhd^Fdf     , Hhd^Fdw     , Rp          , Ur          , Hhd^Fdw     , Hhd^Fmw     , Rd          , Rd          , Ce          , Rb          , Re^Vct      , Ur          , Uu^Dr       , Uue         
Re          , Rb          , Re          , Rb          , Rb          , Re          , Hhd^Fdw     , Hhd^Fmw     , Mm          , Mm          , Mm          , Mm          , Hhd         , Hhd^Fdf     , Hhd^Fdf     , Rp          , Ur          , Uu          , Gd^Fmw      , Rd          , Re          , Re          , Rb          , Ur          , Gs^Fdw      , Uue         , Gd^Fdf      
