border_size=1
usage=map

Xue         , Xue         , Xue         , Xue         , Xue         , Xue         , Xue         , Xue         , Xue         , Xue         , Xue         , Xue         , Xue         , Xue         , Xue         , Xue         , Xue         
Xue         , Xue         , Xue         , Xue         , Xue         , Xue         , Xue         , Xue         , Uu          , Xue         , Xue         , Xue         , Xue         , Xue         , Xue         , Xue         , Xue         
Xue         , Xue         , Xue         , Xue         , Xue         , Xue         , Xu          , Uu^Vu       , Uu          , Uu^Vu       , Xu          , Xue         , Xue         , Xue         , Xue         , Xue         , Xue         
Xue         , Xue         , Xue         , Xue         , Uu^Vu       , Xu          , Xu          , Xu          , 1 Kud       , Xu          , Xu          , Xu          , Uu^Vu       , Xue         , Xuce        , Xue         , Xue         
Xue         , Xue         , Xue         , Uu          , Uu          , Xu          , Xu          , Xu          , Cud         , Xu          , Xu          , Xu          , Uu          , Uu          , Xue         , Xue         , Xue         
Xue         , Xue         , Xue         , Uu^Vu       , Xu          , 6 Kud       , Cud         , Cud         , Cud         , Cud         , Cud         , 4 Kud       , Xu          , Uu^Vu       , Xue         , Xue         , Xue         
Xue         , Xue         , Xue         , Xu          , Xu          , Xu          , Cud         , Cud         , Ql          , Cud         , Cud         , Xu          , Xu          , Xu          , Xue         , Xue         , Xue         
Xue         , Xue         , Xue         , Xu          , Xu          , Xu          , Cud         , Cud         , Cud         , Cud         , Cud         , Xu          , Xu          , Xu          , Xue         , Xue         , Xue         
Xue         , Xue         , Xue         , Uu^Vu       , Uu          , 3 Kud       , Xu          , Cud         , Cud         , Cud         , Xu          , 2 Kud       , Uu          , Uu^Vu       , Xue         , Xue         , Xue         
Xue         , Xue         , Xue         , Uu          , Uu^Vu       , Xu          , Xu          , Xu          , 5 Kud       , Xu          , Xu          , Xu          , Uu^Vu       , Uu          , Xue         , Xue         , Xue         
Xue         , Xue         , Xue         , Xue         , Xue         , Xu          , Xu          , Xu          , Uu          , Xu          , Xu          , Xu          , Xue         , Xue         , Xue         , Xue         , Xue         
Xue         , Xue         , Xue         , Xue         , Xue         , Xue         , Xue         , Uu^Vu       , Uu          , Uu^Vu       , Xue         , Xue         , Xue         , Xue         , Xue         , Xue         , Xue         
Xue         , Xue         , Xue         , Xue         , Xue         , Xue         , Xue         , Xue         , Xue         , Xue         , Xue         , Xue         , Xue         , Xue         , Xue         , Xue         , Xue         
